3333333333333333333333333333333333333333333333333333333333333333333333333333333333333333333333333333
3333333333333333333333333333333333333333333333333333333333333333333333333333333333333333333333333333
3333333333333333333333333333333333333333333333333333333333333333333333333333333333333333333333333333
3333333333333333333333333333333333333333333333333333333333333333333333333333333333333333333333333333
3333111122222222222222222221111113111111111111111111111111311111111111111332222222222222222222223333
3333111122222222222222222221111113111111111111111111111111311111111111111332222222222222222222223333
3333111122222222222222222221111113111111111111111111111111311111111111111332222222222222222222223333
3333111122222222222222222221111113111111111111111111111111311111111111111332222222222222222222223333
3333111122222222222222222221111113111111111111111111111111311111111111111332222222222222222222223333
3333111133333333333333333331111113111111111222332221111111311111111111111332222222333333333222223333
3333111133333333333333333331111113111111111222332221111111311111111111111332222222211111112222223333
3333111111111111111111111111111113111111111222332221111111311111111111111332222222211111112222223333
3333111111111111111111111111111113111111111222332221111111311113333111111333332222211111112222223333
3333111111111111111111111111111113111111111222332221111111311113333111111111122222211111112222223333
3333111111111111111111111111111113111111111222332221111111311113333111111111122222211111112222223333
3333111111111111111111111111111113111111111222332221111111311113333111111111122222211111112222223333
3333111111111111111111111111111113111111111222332221111111311111111111111333332222211111112222223333
3333111133113311333322222331111113111111111222332221111111311111111111111332222222211111112222223333
3333111133113311333322222331111113111111111222332221111111311111111111111332222222333333333222223333
3333111133113311333322222331111113111111111222332221111111311111111111111332222222222222222222223333
3333111133113311333322222331111113111111111222332221111111311111111111111332222222222222222222223333
3333111133113311333322222331111113111111111222332221111111311111111111111332222222222222222222223333
3333111133113311333322222331111113111111111222332221111111311111111111111332222222233333322222223333
3333111111111111111111111111111113111111111222332221111111311111111111111332222222231112222222223333
3333111111111111111111111111111111111111111222332221111111311111111111111332222222231112222222223333
3333111111111111111111111111111111111111111222332221111111311111111111111332222222231112222222223333
3333111111111111111111111111111111111111111222332221111111311111111111111332222222231112222222223333
3333111111111111111111111111111111111111111222332221111111311111111111111333333333331113333333333333
3333333333333331111133333333333333111111111222332221111111311111111111111333333333331113333333333333
3333111111111111111111111111111113111111111222332221111111311111111111111111111111111111111111113333
3333111111111111111111111111111113111111111222332221111111311111111111111111111111111111111111113333
3333111111111311222111111111111113111111111111111111111111111111111111111111111111111111111111113333
3333111111222311222111111111111113111111111111111111111111111111111111111111111111111111111111113333
3333111111222311232111111111111113111111111111111111111111111111111111111111111111111111111111113333
3333111111222311222111111111111113111111111111111111111111111111111111111111111111111111111111113333
3333122211222311223111111111111113111111111111111111111111111111111111111111111111111111111111113333
3333122211223311222112221111133333111111111111111111111111111111111111111111111111111111111111113333
3333123211222311222112221111111111111111111111111111111111111111111111111111111111111111111111113333
3333122211222311232112221112221111111113333333333333333333331111111111111111111111111111111111113333
3333122311232311111112221112221111111113222222222222222222231111111111111111111111111111111111113333
3333122211111311111112231112221111111113222222222222222222231111111111111111111111111111111111113333
3333122211111222111112221112221111111113223223222322222222231111111111111111111111111111111111333333
3333123211111222111112221112231111111113222222222223222232231111111111111111111111111111111111333333
3333111111111322111112321112221111111113222222222222222222231111111111111111111111111111111111333333
3333111111111222111111111112221111111113222222223222222222231111111111111111111111111111111111333333
3333111113111223111111111112321111111113223222222222222222231111111333333333333333331111111111333333
3333111113111222111111111111111111111113222223222223222222231111111333333333333333331111111111333333
3333111113111222111111111111111111111113222222222322223222231111111333333333333333331111111111333333
3333111111111232111111111111111113111113222222222222222222231111111333332222321111331111111111333333
3333111111111111111111111111111113111113222232222222222222231111111333322223331111131111111111333333
3333222222222222222222222222222223111113223222222222222222231111111333222233333111111111111111333333
3333222222222222222222222222222223111113222222322222222222231111111332222333333311111111111111333333
3333222222222222222222222222222223111113222222222322222222231111111322223333333331111111111111333333
3333222222222222222222222222222223111113222232222222322222231111111122222333333311111111111111333333
3333222222222222222222222222222223111113222222222222222232231111111122222233333211131111111111333333
3333222222222222222222222222222223111113223222223222222222231111111122322223332211333111111111333333
3333333333333333333333333333333333333113222222222222222222231111111123332222322213333311111111333333
3333333333333333333333333333333333333113222222222222222222231111111133333222222233333331111111333333
3333322232112221233322213232331123333113333333333333333333331111111333333322222333333333111111333333
3333133212231112113223313312221331133111111111111111111111111111111333333332222233333331111111333333
3333222211313112221323133222321133133222211111111111111111111111111122333322222223333311111111333333
3333311331112322332123212212321231133222211111111111111111111111111122233222222222333111111111333333
3333131211131233321222311321313111133222211111111111111111111111111122232222232222131111111111333333
3333311231211213311323321122212311233222211111111111111111111111111132222222333222111111111111333333
3333131213222121312121211322221123233222211111111111111111111111111133222223333322111111111111333333
3333322213211233232221311211321213133222211111111111111111111111111133222233333332111111111111333333
3333123112133312312332123113221233333222211111111111111111111111111133322333333333111111111111333333
3333313123231323122332222233222132133222211111111112223322211111111133322333333332111111331111333333
3333113212112133222323212313322223333222211111111112223322211111111133332223333322211111331111333333
3333132213323311231133333123231121133222211111111112223322211111111133332222333222221111331111333333
3333221323232321223211132112211211133222211111111112223322211111111133333222222222222111331111333333
3333222131323121111221112232113111133222211111111112223322211111111133333333333333333333331111333333
3333233121322322231232221332211133233222211111111112223322211111111133333333333333333333331111333333
3333123323331211123113112313223331133222211111111112223322211111111133333333333333333333331111113333
3333233223333132121212332332112132333222211111111112223322211111111111111111111111111111331111113333
3333121322311313111311211121311311133222211111111112223322211111111122211111222111122211331111113333
3333211231133232332322132123132322233222211111111112223322211111111122211111222111122211331111113333
3333332311132232221321333212223323233222211111111112223322211111111122211111222111122211331111113333
3333332221321113321111133133332331333222211111111112223322211111111122211111222111122211331111113333
3333213213221113321131233131133231233222211111111112223322211111111122211111222111122211331111113333
3333131233321221221131323313111113233222211111111112223322211111111122211111222111122211331111113333
3333112113321113221232132222112113133222211111111112223322211111111122211111222111122211331111113333
3333232332211122121232223131211133133222211111111112223322211111111122211111222111122211331111113333
3333112221123112233222112211333323133222211111111112223322211111111122211111222111122211331111113333
3333112222233132223211321223222112333222211111111112223322211111111122211111222111122211331111113333
3333321111322233212133213232212313133222211111111112223322211111111122211111222111122211331111113333
3333321233131311222122313312232221233222211111111112223322211111111122211111222111122211331111113333
3333313313321121311211123211232121233222211111111112223322211111111122211111222111122211331111113333
3333132213223311222333333222231222133222211111111112223322211111111122211111222111122211331111113333
3333322121321323112323231122213211333222211111111111111111111111111122211111222111122211331111113333
3333111311233222111211232111322221333222211111111111111111111111111122211111222111122211331111113333
3333133132233322131232131323122131133222211111111111111111111111111122211111222111122211111111113333
3333321112113112123312321321121312333222211111111111111111111111111122211111222111122211331111113333
3333212312312112222132111231133232233222211111111111111111111111111122211111222111122211331111113333
3333111233333312212332133231211131133222211111111111111111111111111122211111222111122211331111113333
3333321233332232121231333233112211233222211111111111111111111111111122211111222111122211331111113333
3333333333333333333333333333333333333333333333333333333333333333333333333333333333333333333333333333
3333333333333333333333333333333333333333333333333333333333333333333333333333333333333333333333333333
3333333333333333333333333333333333333333333333333333333333333333333333333333333333333333333333333333
3333333333333333333333333333333333333333333333333333333333333333333333333333333333333333333333333333
